AGIR - Agência Intermunicipal de Regulação, Controle e Fiscalização de Serviços Públicos Municipais do Médio Vale do Itajaí|AGIR
AGIR - Agência Intermunicipal de Regulação de Serviços Públicos|AGIR
﻿﻿AGÊNCIA PÚBLICA INTERMUNICIPAL DE SERVIÇOS DO VALE EUROPEU - APIS﻿|APIS﻿
APIS - Agência Pública Intermunicipal de Serviços do Vale Europeu - APIS﻿|APIS﻿
ARIS - Agência Reguladora Intermunicipal de Saneamento|ARIS
CIAPS - Consórcio Intermunicipal de Atenção Psicossocial|CIAPS
CIASAMREC - Consórcio Intermunicipal de Atenção à Sanidade Agropecuária da Região Carbonífera de Santa Catarina|CIASAMREC
CIASS - Consorcio Intermunicipal de Assistencia Social e Saude de Turvo e Municpios Limitrofes|CIASS
CICCS - Consórcio Intermunicipal Caminhos dos Cânions do Sul|CICCS
CIDEMA - Consórcio Intermunicipal de Desenvolvimento Econômino, Social e Meio Ambiente|CIDEMA
CIDIRIOS - Consórcio Intermunicipal de Desenvolvimento da Infraestrutura Rodoviária Entre os Rios|CIDIRIOS
CIGA - Consórcio de Informática na Gestão Pública Municipal|CIGA
CIGA - Consórcio de Inovação na Gestão Pública|CIGA
CIGAMERIOS - Consórcio Integrado de Gestão Pública do Entre Rios|CIGAMERIOS
CIGAMVALI - Consórcio Intermunicipal de Gestão Pública do Vale do Itapocu|CIGAMVALI
CIM-AMAI - Consórcio Multifinalitário da Região da AMAI|CIM-AMAI
CIM-AMAVI - Consórcio Intermunicipal Multifinalitário dos Municípios da AMAVI|CIM-AMAVI
CIM-AMFRI - Consórcio Intermunicipal Multifinalitário da Região da AMFRI|CIM-AMFRI
CIM-AMREC - Consórcio Intermunicipal Multifinalitário da AMREC|CIM-AMREC
CIM-AMUNESC - Consórcio Intermunicipal Multifinalitário da Região da AMUNESC|CIM-AMUNESC
CIM-AMUREL - Consórcio Multifinalitário da AMUREL|CIM-AMUREL
CIMPLASC - Consórcio Intermunicipal de Saneamento Básico, Meio Ambiente, Atenção à Sanidade dos Produtos de Origem Agropecuária e Segurança Alimentar|CIMPLASC
CIMVI - Consórcio Intermunicipal do Médio Vale do Itajaí|CIMVI
CINCATARINA - Consórcio Interfederativo Santa Catarina|CINCATARINA
CINFRA - Consórcio Intermunicipal de Infraestrutura Rodoviária da AMESC|CINFRA
CIS/AMEOSC - Consórcio Intermunicipal de Saúde da AMEOSC|CIS/AMEOSC
CISAMARP - Consórcio Intermunicipal de Saúde do Alto Vale do Rio do Peixe|CISAMARP
CISAMARP - Consórcio Público Interfederativo de Saúde do Alto Vale do Rio do Peixe|CISAMARP
CIRSURES - Consórcio Intermunicipal de Resíduos Sólidos Urbanos da Região Sul|CIRSURES
CIS-GRANFPOLIS - Consórcio Intermunicipal de Saúde da Região da Grande Florianópolis|CIS-GRANFPOLIS
CIS-AMAVI - CONSÓRCIO INTERMUNICIPAL DE SAÚDE DO ALTO VALE DO ITAJAÍ|CIS-AMAVI
CIS-AMAVI - Consórcio Intermunicipal de Saúde do Alto Vale do Itajaí|CIS-AMAVI
CISAMAVI - Consórcio Intermunicipal de Saúde e Multifinalitário do Alto Vale do Itajaí|CISAMAVI
CIS/AMARP - Consórcio Intermunicipal de Saúde do Alto Vale do Rio do Peixe|CIS/AMARP
CIS/AMAUC - Consórcio Intermunicipal de Saude do Alto Uruguai Catarinense|CIS/AMAUC
CIS/AMERIOS - Consorcio Intermunicipal de Saude da AMERIOS|CIS/AMERIOS
CIS/AMFRI - Consórcio Intermunicipal de Saúde da Região da Foz do Rio Itajaí|CIS/AMFRI
CIS/AMOSC - Consórcio Intermunicipal de Saúde do Oeste de SC|CIS/AMOSC
CIS/AMOSC - CONSORCIO INTERFEDERATIVO DE SAUDE DO OESTE DE SC|CIS/AMOSC
CIS/AMUREL - Consórcio Intermunicipal de Saúde da AMUREL|CIS/AMUREL
CIS/AMURES - Consórcio Intermunicipal de Saúde da Micro região da AMURES|CIS/AMURES
CIS/AMURES - CONSORCIO INTERMUNICIPAL DE SAUDE DA REGIAO DA AMURES|CIS/AMURES
CIS/AMVI - Consórcio Intermunicipal de Saúde do Médio Vale do Itajaí|CIS/AMVI
CISAM - Consórcio Intermunicipal de Saneamento Ambiental|CISAM
CISAM-SUL - Consórcio Intermunicipal de Saneamento Ambiental|CISAM-SUL
CISAMREC - Consórcio Intermunicipal de Saúde da AMREC|CISAMREC
CISNORDESTE - Consórcio Intermunicipal de Saúde do Nordeste de Santa Catarina|CISNORDESTE
CISSAAC-CLPP - Consórcio Intermunicipal de Serviço Sócio Assistencial de Alta Complexidade - Casa Lar Pequeno Príncipe|CISSAAC-CLPP
CISSAAC-AI - Consórcio Intermunicipal de Serviço Sócio Assistencial de Alta Complexidade - Abrigo Institucional|CISSAAC-AI
CITMAR - Consórcio Intermunicipal de Turismo Costa Verde e Mar|CITMAR
CODEPLAN - Consórcio de Desenvolvimento Econômico do Planalto Norte|CODEPLAN
COINCO - Consórcio Intermunicipal do Contestado|COINCO
CONDER - Consórcio Intermunicipal de Desenvolvimento Regional|CONDER
CONEXSUL - Consórcio Intermunicipal do Extremo Sul Catarinense|CONEXSUL
CONSAD - Cons. Interestadual e Intermunicipal de Mun. de SC, PR e RS, de Seg. Alimentar, Atenção a Sanid. Agrop. e Desenvolvimento Local|CONSAD
Consórcio Catarina - Consórcio Público de Saneamento Básico do Sul de Santa Catarina|
Consórcio CISAMA|CISAMA
CIDAUC - Consórcio Intermunicipal de Desenvolvimento do Alto Uruguai Catarinense|CIDAUC
CIMA - Consórcio Intermunicipal MAMPITUBA|CIMA
CISAMA - Consórcio Intermunicipal Serra Catarinense|CISAMA
CISAMURC - Consórcio Intermunicipal de Saúde da Região do Contestado|CISAMURC
Consórcio da Região do Rio Sargento de Integração Municipal - CRESIM|CRESIM
Consórcio Integrar - Consórcio Intermunicipal de Infraestrutura Urbana e Rural|INTEGRAR
CONSORCIO INTERMUNICIPAL DE DESENVOLVIMENTO DO ALTO URUGUAI CATARINENSE - CIDAUC|CIDAUC
Consórcio Intermunicipal de Insfraestrutura e Desenvolvimento da Região do Vale do Rio Mampituba - Consórcio Mampituba|MAMPITUBA
Consórcio Intermunicipal de Saúde da Região do Contestado – CISAMURC|CISAMURC
Consórcio Intermunicipal de Serviço Sócio Assistencial de Alta Complexidade - Abrigo Institucional|CISSAAC-AI
Consórcio Intermunicipal de Serviço Sócio Assistêncial de Alta Complexidade - Casa Lar Pequeno Príncipe|CISSAAC-CLPP
Consórcio Intermunicipal MAMPITUBA - CIMA|CIMA
Consórcio Intermunicipal Multifinalitário da AMREC - CIM-AMREC|CIM-AMREC
Consórcio Intermunicipal Multifinalitário da Grande Florianópolis - CIM-GRANFPOLIS|CIM-GRANFPOLIS
Consórcio Intermunicipal Multifinalitário da Região da AMFRI – CIM-AMFRI|CIM-AMFRI
Consórcio Intermunicipal Multifinalitário de Gestão Pública da AMESC - CIMGEPA|CIMGEPA
Consórcio Intermunicipal Quiriri|QUIRIRI
Consórcio Intermunicipal Velho Coronel - CVC|CVC
Consórcio Lambari - Consórcio Intermunicipal Multifinalitário do Alto Uruguai Catarinense|LAMBARI
CONTRILHOS - Consórcio de Turismo nos Trilhos do Contestado|CONTRILHOS
CONVALE - Consórcio do Vale do Rio Tijucas|CONVALE
CONVALES - Consórcio dos Vales dos rios Tijucas e Itajaí Mirim|CONVALES
CPIMMOC - Consórcio Público Intermunicipal Multifinalitário Meio Oeste Contestado|CPIMMOC
CVC - Consórcio Intermunicipal Velho Coronel|CVC
IBERE - Consórcio Intermunicipal de Gerenciamento Ambiental|IBERE
INTEGRAR - Consórcio Intermunicipal de Infraestrutura Urbana e Rural|INTEGRAR
LAMBARI - Consórcio Intermunicipal Multifinalitário do Alto Uruguai Catarinense|LAMBARI
